Exílio Ancestral - Juggernaut (1)
Adepta da Lâmina Sombria - Templar Assassin (2)
Infernal Ígneo - Doom (1)
Bucaneira de Porão - Hoodwink (2)
Infantaria de Tomo'kan - Hoodwink (1)
Discípula Onikage - Phantom Assassin (1)
Tentáculos Atemporais - Faceless Void (2)
Reformista da Forja Estelar - Dawnbreaker (2)
Sanguo, o Urso - Ursa (2)
Troféus da Caça Sagrada - Ursa (1)
Receptáculo Perverso - Shadow Demon-set  imortal(1)
Conquistador Aveludado - Pudge Persona (1)
Desenhos Dracônicos - Antimage Persona (1)
Rosa da Moira - Muerta (3)
Bandoleira da Asa Negra - Muerta (4)
Verminador - Bounty Hunter (1)
Horizontes Prenunciados - Oracle (2)
Bardo Fantasmagórico - Abaddon (2)
Sombra Espectral - Abaddon (1)
Elegia do Ceifador - Grimstroke (1)
Escaramuça da Saturnália - Snapfire (2)
Corrida Armada de Ardal - Snapfire (1)
Svarog, o Infernal - Fera Primal (2)
Beemote das Sombras  - Fera Primal, Muito Raro(1)
Vermelhinha - Marci+Pet+Taunt (1)
Fortuna Fiel - Marci (3)
Guerreira da Lua - Marci (1)
Nyx Mecânico - Nyx (2)
Quimera Infernal - Lion (1)
Entropia Desacorrentada - Ancient (2)
Fachada Fantasma - Phantom Assassin Persona (1)
Estado de Choque - Zeus  (1)
Terror do Anoitecer - Night Stalker (1)
Martírio da Salmoura - Naga Siren (3)
Lótus do Clã do Urso Montanhês - Meepo (2)
Tarterror Colossal - Tiny (3)
Agonias Requintadas - Queen of Pain (1)
Necromante Bordado - Dazzle (2)
Louvor do Bosque Sombrio - Death Prophet (3)
Mini e Tauro - Alchmist (1)
Transgressão de Sombreja - Alchmist (1)
Espírito do Mar - Kunkka (1)
Sofrimento Ardente - Clinks (1)
Guardião da Câmara Sagrada - Huskar (1)
Alvorada Carmesim - Fênix (1)
Cães da Obsessão - Chen (1)
Defensor das Ruínas - Disruptor set aberto muito raro(1)
Caçador de Engraxates - Axe (1)
Estrela Cerúlea - Enchantress (1)
Espólios do Marinheiro - Clockwerk (1)